1111111111011000
1111111111100100
0000000000110001
0000000010110001
0000000010010110
1111111100010000
1111110100010110
1111110111000001
0000001110010101
0000110011111111
0001010001010010
0001010001010010
0000110011111111
0000001110010101
1111110111000001
1111110100010110
1111111100010000
0000000010010110
0000000010110001
0000000000110001
1111111111100100
1111111111011000
